R 1080 720
NO ./parsing/visual/wall.xpm
SO ./parsing/visual/exit.xpm
WE ./parsing/visual/wall_big_yellow_duck.xpm
EA ./parsing/visual/coll.xpm
C 255,200,160
F  

    111111111111111111111111111111111111111111111111111111111111111
        100000000011000000000000100000000000010000000100000000000000001
        101100000111000000000000100000000000001000001000000000000000001
        100100000000000000000000100000000000000100010000000000000000001
11111111101100000111000000000000100000000000000010100000000000000000001
10000000001100000111011111111111100000000000000001000000000000000000001
11110111111111011100000010001000000000000000000000000000000000000000001
11110111111111011101010010001000000000000000000000000000000000000000001
11000000110101011100000000001000000000000000000000000000000000000000001
10000000000000001100000010001000000000000000000000000000000000000000001
10000000000000001101010010001000000000000000000000000000000000000000001
11000001110101011111011110001000000000000000000000000000000000000000001
11110111 1110101 1011110100000000000000000000000000000000000000000000N1
11111111 1111111 111111111111111111111111111111111111111111111111111111