
NO ./visual/wall.xpm
SO ./visual/exit.xpm
WE ./visual/wall_big_yellow_duck.xpm
EA ./visual/coll.xpm

F 177, 156, 217
C 251, 197, 180

        111111111111111111111111111111111111111111111111111111111111111
        100000000011000000000000100000000000010000000100000000000000001
        101100000111000000000000100000000000001000001000000000000000001
        100100000000000000000000100000000000000100010000000000000000001
11111111101100000111000000000000100000000000000010100000000000000000001
10000000001100000111011111111111100000000000000001000000000000000000001
11110111111111011100000010001000000000000000000000000000000000000000001                    11111111
11110111111111011101010010001000000000000000000000000000000000000000001                    10000001
110000001101010111000000000010000000111000010000000000000000000000000011111111111111111111111110011
1000000000000000110000001000100000001 1000000000000000000000000000000000000000000000000000000000001
100000000000000011010100100010000000111000000000000000000000000000000011111111111111111111111111011
11000001110101011111011110001000000000000000000000000000000000000000001                       110111111111
11110111 1110101 1011110100000000000000000000000000000000000000000000N1                       100000000001
11111111 1111111 11111111111111111111111111111111111111111111111111111111111111111111111111111100000000001
                                                                                              111111111111
                                             1111111111111111111111111111111