NO ./visual/wall.xpm
SO ./visual/exit.xpm
WE ./visual/wall_big_yellow_duck.xpm
EA ./visual/coll.xpm

F 177, 156, 217
C 251, 197, 180

        1111111111111111111111111
        1001000000010000000000001
111111111011000000001111110000001
111101111100100000000000000010001     11111111
111101111100000000000000000000001     10000001
110000000000000100001111111110011     11111111
1000000000000000110000000000000011111111111111
10000000000000001101010010001111111111111111011
11000001110101011111111111111111100000000000001  
11110111 1110101 10111101000000000000000N000111
11111111 1111111 111111111111111111111111111111111 1
11111111111111111111111111111111111111111111