111111111111111
10000C0000C0001
10000P000000001
100010101010001
11110C00000C001
1000000C0000001
100000E00000001
10000C00000C0C1
111111111111111
