11111111111111111111
1000011000000C000001
100P000000C00000C001
1000000C000C00001101
100000E000000C000001
1000000000P000000001
1000000E010000010C01
10000000000CCCC00001
11111111111111111111
