1111111111
1000010001
10010P0001
10C0000001
10000C0001
1C00001001
1000000001
100E000C11
1111111111
